10 10
3 4
9 9
3	8	7	0	1	9	8	4	0	9	
2	5	6	0	4	2	0	7	2	8	
4	0	2	8	5	1	6	9	9	7	
6	0	9	0	8	1	8	8	6	9	
2	7	8	5	7	3	8	4	6	3	
2	0	9	4	9	0	1	1	0	6	
4	3	1	8	8	7	0	1	2	5	
1	7	7	3	2	2	0	7	9	0	
4	1	6	6	2	5	2	0	6	9	
9	1	4	1	8	2	9	3	8	9	