20 20
2 1
6 18
3	0	1	7	5	4	3	7	7	2	6	7	7	6	5	3	4	1	5	6	
8	3	4	4	8	8	3	4	7	9	3	5	5	3	2	7	3	9	0	5	
2	9	4	9	5	6	7	7	4	9	6	7	0	0	3	9	2	2	0	9	
8	8	5	3	9	1	6	0	6	9	6	8	9	5	2	7	4	0	1	3	
9	1	8	1	5	3	1	5	1	9	5	6	0	5	6	1	3	0	2	5	
2	1	3	9	0	8	8	7	5	0	2	4	6	9	6	6	0	3	2	9	
2	8	2	5	8	3	4	4	7	3	7	5	9	6	7	9	2	6	8	7	
7	0	6	9	1	7	6	2	0	2	7	0	3	0	0	5	7	8	6	5	
6	4	3	9	9	0	9	3	0	4	3	8	4	7	7	7	5	2	8	3	
5	3	4	7	7	4	5	9	1	1	6	6	7	4	4	5	3	8	0	1	
0	9	1	7	5	5	7	9	8	0	5	1	9	6	5	2	9	3	3	2	
1	5	6	7	6	7	2	7	7	5	0	2	7	1	6	8	3	9	0	2	
2	3	2	2	8	7	7	3	3	7	2	3	8	7	8	9	0	1	6	0	
5	5	6	4	1	0	3	7	8	6	2	9	4	8	5	7	2	5	0	7	
9	6	9	3	5	5	3	2	9	4	3	3	8	0	6	5	6	7	4	9	
4	2	5	8	8	1	6	2	6	3	9	1	3	3	3	5	8	1	5	1	
5	3	6	2	2	1	5	1	2	4	9	6	5	9	2	2	2	0	4	3	
2	9	2	4	4	2	4	7	1	5	8	6	8	4	4	6	3	0	9	0	
5	0	3	5	9	7	8	0	1	4	9	4	0	5	1	6	0	1	5	6	
4	1	6	0	7	7	0	0	2	7	7	2	5	5	8	0	9	8	2	1	